R 1280 800

 NO xpmfiles/stone.xpm


SO xpmfiles/cobblestone.xpm


WE xpmfiles/stonebrick.xpm

EA xpmfiles/cobblemoss.xpm


S xpmfiles/fire.xpm

F 81,129,67
C 85,209,234

        1111111111111111111111111
       11000000000110000000000001
      111011000001110000000000001
     1111001000000000000000000001
111111111011000001110000000000001
100000000011000001110111110111111
11110111111111011100000010001
11110111111111011101010010201
11000000110101011100000010001
10000000000000001100000010001
10000000000000001101010010001
11000000110101011111011110N0111
11110111 1110101 101111010001
11111111 1111111 111111111111