R 1280 800

 NO xpmfiles/stone.xpm


SO xpmfiles/cobblestone.xpm

WE xpmfiles/stonebrick.xpm

EA xpmfiles/cobblemoss.xpm


S xpmfiles/fire.xpm

F 81,129,67
C 85,209,234

1111111111111111111111111111
100000000000000000000000000111
100E000000000000222000000000111
10000000000000000000000000000011
10000000011111000000000000000001
1000000001   10000000001111111111
1000000001111100000000011111
100000000000000000000001
100000000000000000000001  1 111 11 11
1111100000000000000000011 1 11 1 1 1 
    11100000001110000001
      111100001 10000001
        1111111 11111111  1 1 1 1 1 1